SampleID	Response	Train_Group	Detail_Group
Breast-P1	Cancer	Cancer	Breast-Cancer
Breast-P2	Cancer	Cancer	Breast-Cancer
Breast-P5	Cancer	Cancer	Breast-Cancer
Breast-P7	Cancer	Cancer	Breast-Cancer
Breast-P10	Cancer	Cancer	Breast-Cancer
Breast-P12	Cancer	Cancer	Breast-Cancer
Breast-P13	Cancer	Cancer	Breast-Cancer
Breast-P15	Cancer	Cancer	Breast-Cancer
Breast-P17	Cancer	Cancer	Breast-Cancer
Breast-P18	Cancer	Cancer	Breast-Cancer
Breast-P19	Cancer	Cancer	Breast-Cancer
Breast-P20	Cancer	Cancer	Breast-Cancer
Breast-P21	Cancer	Cancer	Breast-Cancer
Breast-P23	Cancer	Cancer	Breast-Cancer
Breast-P25	Cancer	Cancer	Breast-Cancer
Breast-P26	Cancer	Cancer	Breast-Cancer
Breast-P27	Cancer	Cancer	Breast-Cancer
Breast-P31	Cancer	Cancer	Breast-Cancer
Breast-P32	Cancer	Cancer	Breast-Cancer
Breast-P35	Cancer	Cancer	Breast-Cancer
Breast-P37	Cancer	Cancer	Breast-Cancer
Breast-P40	Cancer	Cancer	Breast-Cancer
Breast-P42	Cancer	Cancer	Breast-Cancer
Breast-P44	Cancer	Cancer	Breast-Cancer
Breast-P47	Cancer	Cancer	Breast-Cancer
Breast-P48	Cancer	Cancer	Breast-Cancer
Breast-P50	Cancer	Cancer	Breast-Cancer
Breast-P52	Cancer	Cancer	Breast-Cancer
Breast-P53	Cancer	Cancer	Breast-Cancer
Breast-P54	Cancer	Cancer	Breast-Cancer
Breast-P55	Cancer	Cancer	Breast-Cancer
Breast-P57	Cancer	Cancer	Breast-Cancer
Breast-P59	Cancer	Cancer	Breast-Cancer
Breast-P64	Cancer	Cancer	Breast-Cancer
Breast-P65	Cancer	Cancer	Breast-Cancer
Breast-P66	Cancer	Cancer	Breast-Cancer
Breast-P67	Cancer	Cancer	Breast-Cancer
Breast-P70	Cancer	Cancer	Breast-Cancer
Breast-P76	Cancer	Cancer	Breast-Cancer
Breast-P79	Cancer	Cancer	Breast-Cancer
Breast-P81	Cancer	Cancer	Breast-Cancer
Breast-P82	Cancer	Cancer	Breast-Cancer
Breast-P85	Cancer	Cancer	Breast-Cancer
Breast-P87	Cancer	Cancer	Breast-Cancer
Breast-P88	Cancer	Cancer	Breast-Cancer
Breast-P89	Cancer	Cancer	Breast-Cancer
Breast-P90	Cancer	Cancer	Breast-Cancer
Breast-P91	Cancer	Cancer	Breast-Cancer
Breast-P92	Cancer	Cancer	Breast-Cancer
Breast-P94	Cancer	Cancer	Breast-Cancer
Breast-P96	Cancer	Cancer	Breast-Cancer
Breast-P97	Cancer	Cancer	Breast-Cancer
Breast-P98	Cancer	Cancer	Breast-Cancer
Breast-P101	Cancer	Cancer	Breast-Cancer
Breast-P103	Cancer	Cancer	Breast-Cancer
Breast-P104	Cancer	Cancer	Breast-Cancer
Breast-P105	Cancer	Cancer	Breast-Cancer
Breast-P106	Cancer	Cancer	Breast-Cancer
Breast-P108	Cancer	Cancer	Breast-Cancer
Breast-P109	Cancer	Cancer	Breast-Cancer
Breast-P111	Cancer	Cancer	Breast-Cancer
Breast-P113	Cancer	Cancer	Breast-Cancer
Breast-P114	Cancer	Cancer	Breast-Cancer
Breast-P119	Cancer	Cancer	Breast-Cancer
Breast-P121	Cancer	Cancer	Breast-Cancer
Breast-P122	Cancer	Cancer	Breast-Cancer
Breast-P126	Cancer	Cancer	Breast-Cancer
Breast-P127	Cancer	Cancer	Breast-Cancer
Breast-P128	Cancer	Cancer	Breast-Cancer
Breast-P129	Cancer	Cancer	Breast-Cancer
Breast-P130	Cancer	Cancer	Breast-Cancer
Breast-P131	Cancer	Cancer	Breast-Cancer
Breast-P132	Cancer	Cancer	Breast-Cancer
Breast-P134	Cancer	Cancer	Breast-Cancer
Breast-P136	Cancer	Cancer	Breast-Cancer
Breast-P137	Cancer	Cancer	Breast-Cancer
Breast-P139	Cancer	Cancer	Breast-Cancer
Breast-P140	Cancer	Cancer	Breast-Cancer
Breast-P142	Cancer	Cancer	Breast-Cancer
Breast-P143	Cancer	Cancer	Breast-Cancer
Breast-P144	Cancer	Cancer	Breast-Cancer
Breast-P145	Cancer	Cancer	Breast-Cancer
Breast-P147	Cancer	Cancer	Breast-Cancer
Breast-P149	Cancer	Cancer	Breast-Cancer
Breast-P150	Cancer	Cancer	Breast-Cancer
Breast-P151	Cancer	Cancer	Breast-Cancer
Breast-P153	Cancer	Cancer	Breast-Cancer
Breast-P154	Cancer	Cancer	Breast-Cancer
Breast-P155	Cancer	Cancer	Breast-Cancer
Breast-P157	Cancer	Cancer	Breast-Cancer
Breast-P158	Cancer	Cancer	Breast-Cancer
Breast-P160	Cancer	Cancer	Breast-Cancer
Breast-P161	Cancer	Cancer	Breast-Cancer
Breast-P162	Cancer	Cancer	Breast-Cancer
Breast-P163	Cancer	Cancer	Breast-Cancer
Breast-P164	Cancer	Cancer	Breast-Cancer
Breast-P167	Cancer	Cancer	Breast-Cancer
Breast-P169	Cancer	Cancer	Breast-Cancer
Breast-P171	Cancer	Cancer	Breast-Cancer
Breast-P172	Cancer	Cancer	Breast-Cancer
Breast-P173	Cancer	Cancer	Breast-Cancer
Breast-P181	Cancer	Cancer	Breast-Cancer
Breast-P182	Cancer	Cancer	Breast-Cancer
Breast-P184	Cancer	Cancer	Breast-Cancer
Breast-P185	Cancer	Cancer	Breast-Cancer
Breast-P186	Cancer	Cancer	Breast-Cancer
Breast-P188	Cancer	Cancer	Breast-Cancer
Breast-P190	Cancer	Cancer	Breast-Cancer
Breast-P191	Cancer	Cancer	Breast-Cancer
Breast-P193	Cancer	Cancer	Breast-Cancer
Breast-P194	Cancer	Cancer	Breast-Cancer
Breast-P195	Cancer	Cancer	Breast-Cancer
Breast-P197	Cancer	Cancer	Breast-Cancer
Breast-P198	Cancer	Cancer	Breast-Cancer
Breast-P200	Cancer	Cancer	Breast-Cancer
Breast-P201	Cancer	Cancer	Breast-Cancer
Breast-P202	Cancer	Cancer	Breast-Cancer
Breast-P203	Cancer	Cancer	Breast-Cancer
Breast-P204	Cancer	Cancer	Breast-Cancer
Healthy-P1	Healthy	Healthy	Healthy-Healthy
Healthy-P2	Healthy	Healthy	Healthy-Healthy
Healthy-P4	Healthy	Healthy	Healthy-Healthy
Healthy-P6	Healthy	Healthy	Healthy-Healthy
Healthy-P7	Healthy	Healthy	Healthy-Healthy
Healthy-P9	Healthy	Healthy	Healthy-Healthy
Healthy-P12	Healthy	Healthy	Healthy-Healthy
Healthy-P14	Healthy	Healthy	Healthy-Healthy
Healthy-P15	Healthy	Healthy	Healthy-Healthy
Healthy-P16	Healthy	Healthy	Healthy-Healthy
Healthy-P20	Healthy	Healthy	Healthy-Healthy
Healthy-P22	Healthy	Healthy	Healthy-Healthy
Healthy-P24	Healthy	Healthy	Healthy-Healthy
Healthy-P27	Healthy	Healthy	Healthy-Healthy
Healthy-P29	Healthy	Healthy	Healthy-Healthy
Healthy-P30	Healthy	Healthy	Healthy-Healthy
Healthy-P31	Healthy	Healthy	Healthy-Healthy
Healthy-P32	Healthy	Healthy	Healthy-Healthy
Healthy-P33	Healthy	Healthy	Healthy-Healthy
Healthy-P34	Healthy	Healthy	Healthy-Healthy
Healthy-P35	Healthy	Healthy	Healthy-Healthy
Healthy-P36	Healthy	Healthy	Healthy-Healthy
Healthy-P37	Healthy	Healthy	Healthy-Healthy
Healthy-P38	Healthy	Healthy	Healthy-Healthy
Healthy-P39	Healthy	Healthy	Healthy-Healthy
Healthy-P40	Healthy	Healthy	Healthy-Healthy
Healthy-P41	Healthy	Healthy	Healthy-Healthy
Healthy-P44	Healthy	Healthy	Healthy-Healthy
Healthy-P46	Healthy	Healthy	Healthy-Healthy
Healthy-P48	Healthy	Healthy	Healthy-Healthy
Healthy-P49	Healthy	Healthy	Healthy-Healthy
Healthy-P51	Healthy	Healthy	Healthy-Healthy
Healthy-P53	Healthy	Healthy	Healthy-Healthy
Healthy-P55	Healthy	Healthy	Healthy-Healthy
Healthy-P58	Healthy	Healthy	Healthy-Healthy
Healthy-P59	Healthy	Healthy	Healthy-Healthy
Healthy-P62	Healthy	Healthy	Healthy-Healthy
Healthy-P63	Healthy	Healthy	Healthy-Healthy
Healthy-P64	Healthy	Healthy	Healthy-Healthy
Healthy-P65	Healthy	Healthy	Healthy-Healthy
Healthy-P66	Healthy	Healthy	Healthy-Healthy
Healthy-P67	Healthy	Healthy	Healthy-Healthy
Healthy-P68	Healthy	Healthy	Healthy-Healthy
Healthy-P72	Healthy	Healthy	Healthy-Healthy
Healthy-P73	Healthy	Healthy	Healthy-Healthy
Healthy-P75	Healthy	Healthy	Healthy-Healthy
Healthy-P76	Healthy	Healthy	Healthy-Healthy
Healthy-P78	Healthy	Healthy	Healthy-Healthy
Healthy-P79	Healthy	Healthy	Healthy-Healthy
Healthy-P80	Healthy	Healthy	Healthy-Healthy
Healthy-P84	Healthy	Healthy	Healthy-Healthy
Healthy-P85	Healthy	Healthy	Healthy-Healthy
Healthy-P86	Healthy	Healthy	Healthy-Healthy
Healthy-P87	Healthy	Healthy	Healthy-Healthy
Healthy-P88	Healthy	Healthy	Healthy-Healthy
Healthy-P89	Healthy	Healthy	Healthy-Healthy
Healthy-P91	Healthy	Healthy	Healthy-Healthy
Healthy-P92	Healthy	Healthy	Healthy-Healthy
Healthy-P93	Healthy	Healthy	Healthy-Healthy
Healthy-P94	Healthy	Healthy	Healthy-Healthy
Healthy-P95	Healthy	Healthy	Healthy-Healthy
Healthy-P96	Healthy	Healthy	Healthy-Healthy
Healthy-P99	Healthy	Healthy	Healthy-Healthy
Healthy-P104	Healthy	Healthy	Healthy-Healthy
Healthy-P106	Healthy	Healthy	Healthy-Healthy
Healthy-P108	Healthy	Healthy	Healthy-Healthy
Healthy-P110	Healthy	Healthy	Healthy-Healthy
Healthy-P111	Healthy	Healthy	Healthy-Healthy
Healthy-P113	Healthy	Healthy	Healthy-Healthy
Healthy-P114	Healthy	Healthy	Healthy-Healthy
Healthy-P116	Healthy	Healthy	Healthy-Healthy
Healthy-P117	Healthy	Healthy	Healthy-Healthy
Healthy-P120	Healthy	Healthy	Healthy-Healthy
Healthy-P121	Healthy	Healthy	Healthy-Healthy
Healthy-P125	Healthy	Healthy	Healthy-Healthy
Healthy-P126	Healthy	Healthy	Healthy-Healthy
Healthy-P127	Healthy	Healthy	Healthy-Healthy
Healthy-P129	Healthy	Healthy	Healthy-Healthy
Healthy-P132	Healthy	Healthy	Healthy-Healthy
Healthy-P134	Healthy	Healthy	Healthy-Healthy
Healthy-P135	Healthy	Healthy	Healthy-Healthy
Healthy-P137	Healthy	Healthy	Healthy-Healthy
Healthy-P138	Healthy	Healthy	Healthy-Healthy
Healthy-P139	Healthy	Healthy	Healthy-Healthy
Healthy-P140	Healthy	Healthy	Healthy-Healthy
Healthy-P141	Healthy	Healthy	Healthy-Healthy
Healthy-P144	Healthy	Healthy	Healthy-Healthy
Healthy-P145	Healthy	Healthy	Healthy-Healthy
Healthy-P148	Healthy	Healthy	Healthy-Healthy
Healthy-P151	Healthy	Healthy	Healthy-Healthy
Healthy-P155	Healthy	Healthy	Healthy-Healthy
Healthy-P158	Healthy	Healthy	Healthy-Healthy
Healthy-P163	Healthy	Healthy	Healthy-Healthy
Healthy-P165	Healthy	Healthy	Healthy-Healthy
Healthy-P166	Healthy	Healthy	Healthy-Healthy
Healthy-P167	Healthy	Healthy	Healthy-Healthy
Healthy-P169	Healthy	Healthy	Healthy-Healthy
Healthy-P170	Healthy	Healthy	Healthy-Healthy
Healthy-P171	Healthy	Healthy	Healthy-Healthy
Healthy-P174	Healthy	Healthy	Healthy-Healthy
Healthy-P175	Healthy	Healthy	Healthy-Healthy
Healthy-P176	Healthy	Healthy	Healthy-Healthy
Healthy-P178	Healthy	Healthy	Healthy-Healthy
Healthy-P179	Healthy	Healthy	Healthy-Healthy
Healthy-P180	Healthy	Healthy	Healthy-Healthy
Healthy-P181	Healthy	Healthy	Healthy-Healthy
Healthy-P183	Healthy	Healthy	Healthy-Healthy
Healthy-P185	Healthy	Healthy	Healthy-Healthy
Healthy-P186	Healthy	Healthy	Healthy-Healthy
Healthy-P187	Healthy	Healthy	Healthy-Healthy
Healthy-P188	Healthy	Healthy	Healthy-Healthy
Healthy-P189	Healthy	Healthy	Healthy-Healthy
